biologist|n.|ç”Ÿç‰©å­¦å®¶
zoologist|n.|åŠ¨ç‰©å­¦å®¶
ecologist|n.|ç”Ÿæ€å­¦å®¶
botanist|n.|æ¤ç‰©å­¦å®¶
mammal|n.|å“ºä¹³åŠ¨ç‰©
primate|n.|çµé•¿åŠ¨ç‰©
vertebrate|n.|è„Šæ¤åŠ¨ç‰©
reptile|n.|çˆ¬è¡ŒåŠ¨ç‰©
amphibian|n./adj.|ä¸¤æ –åŠ¨ç‰©/ä¸¤æ –çš„
carnivore|n.|è‚‰é£ŸåŠ¨ç‰©
herbivore|n.|é£Ÿè‰åŠ¨ç‰©
creature|n.|ç”Ÿç‰©ï¼›åŠ¨ç‰©
wildlife|n.|é‡ç”ŸåŠ¨æˆ‘
fauna|n.|ï¼ˆå°¤æŒ‡æŸä¸€åœ°åŒºçš„ï¼‰åŠ¨ç‰©ç¾¤|The park is also home to grizzly bears, and other Rocky Mountain faunas
flora|n.|ï¼ˆå°¤æŒ‡æŸä¸€åœ°åŒºçš„ï¼‰æ¤ç‰©ç¾¤
species|n.|ç‰©ç§
flock|n./v.|ï¼ˆç¾Šæˆ–é¸Ÿï¼‰ç¾¤/èšé›†|Sheep usually flock together
herd|n.|å…½ç¾¤ï¼›ç•œç¾¤|The herdsman looks after a herd of animals
swarm|n.|ï¼ˆèœœèœ‚æ˜†è™«çš„ï¼‰ä¸€å¤§ç¾¤ï¼›ï¼ˆå¿«é€Ÿç§»åŠ¨çš„ï¼‰äººç¾¤
throng|n./v.|äººç¾¤/ç¾¤é›†
crowd|n.|äººç¾¤ï¼›è§‚ä¼—ï¼›ä¸€ç¾¤äºº
beast|n.|é‡å…½ï¼›å‡¶æ®‹çš„äººï¼›ç•œç”Ÿ
brute|n.|ç²—é‡çš„äººï¼›æ®‹å¿çš„äºº|We all want punish the brute
cruel|adj.|æ®‹å¿çš„ï¼›æ®‹æš´çš„
originate|v.|å‘æºï¼›æ¥è‡ªï¼›åˆ›å§‹
derive|v.|å¾—åˆ°ï¼›ï¼ˆä½¿ï¼‰æºè‡ª|I derived a lot of pleasure from meeting new people at college|derive from/be derived from æºè‡ªï¼›æ¥è‡ª
stem|v./n.|èµ·æºäºï¼›æ¥è‡ª/èŒï¼›æ¢—|Correct decisions stem from correct judgments|stem from æºè‡ªï¼›èµ·æºäº
ancestor|n.|ç¥–å®—ï¼›ç¥–å…ˆ
descendant|n./adj.|åè£”ï¼›åä»£/ä¸‹é™çš„
offspring|n.|åä»£ï¼›å­å­™ï¼›äº§ç‰©
subgroup|n.|å­ç¾¤|According to a subgroup analysis, violence produce more violence
feed|v.|ä¾›å…»ï¼›å–‚å…»ï¼›è¿›é£Ÿ
breed|v./n.|é¥²å…»ï¼›ç¹æ®–/å“ç§
interbreed|v.|ï¼ˆä½¿ï¼‰å“ç§æ‚äº¤
hybridize/hybridise|v.|ï¼ˆä½¿ï¼‰æ‚äº¤
proliferate|v.|è¿…é€Ÿå¢æ®–ï¼›å‰§å¢
sterility|n.|ä¸ç”Ÿè‚²|This disease causes sterility in both males and females
mate|v./n.|äº¤é…/é…å¶
courtship|n.|æ±‚å¶
lay|v.|äº§ï¼›æ”¾ç½®ï¼›é“ºè®¾|They lay eggs from the July to the middle of August
hatch|v./n.|å­µåŒ–
brood|n./v.|ä¸€çªå¹¼é¸Ÿï¼›å­µï¼ˆè›‹ï¼‰|The bird was trying to find food for its brood
spawn|n./v.|ï¼ˆé±¼ã€è›™çš„ï¼‰åµï¼›äº§åµï¼›å¼•èµ·
mature|adj./v.|æˆç†Ÿçš„ï¼›æˆç†Ÿ|You are a mature man now, you are no longer a boy|immature adj. ä¸æˆç†Ÿçš„ï¼Œæœªå®Œå…¨å‘è‚²çš„
claw|n./v.|çˆªï¼›é’³ï¼›é³Œï¼›çˆªçŠ¶ç‰©/æŠ“ï¼›æŒ ï¼›æ’•
paw|n.|ï¼ˆåŠ¨ç‰©çš„ï¼‰è„šæŒï¼›çˆªå­
beak|n.|é¸Ÿå˜´ï¼›å–™
fin|n.|é³
plume|n.|ç¾½æ¯›
feather|n.|ç¾½æ¯›||"plume" æ›´å¼ºè°ƒè£…é¥°æ€§å’Œåä¸½ï¼Œè€Œ "feather" åˆ™æ›´é€šç”¨ï¼Œç”¨äºæè¿°é¸Ÿç±»çš„æ™®é€šç¾½æ¯›
fur|n.|è½¯æ¯›ï¼›æ¯›çš®
bristle|n.|é¬ƒæ¯›ï¼›çŸ­è€Œç¡¬çš„æ¯›ï¼Œåˆšæ¯›
curl|n./v.|å·æ›²ï¼›èºæ—‹çŠ¶ç‰©/ï¼ˆä½¿ï¼‰å·æ›²||"curl" æ›´å¼ºè°ƒå¼¯æ›²æˆ–å·æ›²çš„åŠ¨ä½œæˆ–å½¢çŠ¶ï¼Œè€Œ "curve" æ›´å€¾å‘äºæè¿°æ›²çº¿çš„å½¢çŠ¶æˆ–è€…è¶‹åŠ¿ã€‚
insect|n.|æ˜†è™«
worm|n.|è •è™«
pest|n.|å®³è™«ï¼›æœ‰å®³åŠ¨ç‰©
parasite|n.|å¯„ç”Ÿè™«|The life of the parasite is maintained by new blood-sucking mosquitoes
spider|n.|èœ˜è››
butterfly|n.|è´è¶
mosquito|n.|èšŠå­
cricket|n.|èŸ‹èŸ€
penguin|n.|ä¼é¹…
tortoise|n.|é¾Ÿï¼›é™†é¾Ÿ
turtle|n.|æµ·é¾Ÿ
whale|n./v.|é²¸ï¼›æ•é²¸
kangaroo|n.|è¢‹é¼ 
camel|n.|éª†é©¼
elephant|n.|å¤§è±¡
trunk|n.|è±¡é¼»||è¿™ä¸ªè¯å’Œæ¤ç‰©ç ”ç©¶é‚£ä¸ªæ ‘å¹²æ˜¯ä¸€ä¸ªè¯
ivory|n.|è±¡ç‰™|The professor lived in an ivory tower
horn|n.|ï¼ˆç‰›ç¾Šç­‰åŠ¨ç‰©çš„ï¼‰è§’ï¼›ï¼ˆä¹å™¨çš„ï¼‰å·
dragon|n.|é¾™ï¼›æ‚å¦‡|Dragons are describes as monsters in most western countries
cub|n.|å¹¼å…½|The cub licked the milk from its mother's breast
calf|n.|å¹¼å…½ï¼›å°ç‰›ğŸ‚|Did you see the cow with her calf
pup|n.|å¹¼å°åŠ¨ç‰©|I'll get you an Alsatian pup for Christmas|puppy n. å¹¼çŠ¬ã€‚Alsatian n. é˜¿å°”è¨æ–¯ç‹¼ç‹—ï¼Œå¾·å›½ç‰§ç¾ŠçŠ¬ï¼ˆåŒ German shepherdï¼‰
lamb|n.|ç¾”ç¾Š|The little lamb was caught by the wolf|a lost lamb è¿·é€”çš„ç¾”ç¾Š
cattle|n.|ç‰›
ox|n.|ï¼ˆé˜‰å‰²çš„ï¼‰å…¬ç‰›||å¤æ•°å½¢å¼ oxen
bull|n.|å…¬ç‰›|He was a great bull of a man
buffalo|n.|æ°´ç‰›ï¼›é‡ç‰›
zebra|n.|æ–‘é©¬ğŸ¦“
donkey|n.|é©´å­
saddle|n.|éï¼›é©¬éï¼›è½¦åº§|He was putting a saddle on the horse|get into the saddle ä¸Šé©¬
harness|n.|é©¬å…·ï¼›æŒ½å…·|You cannot judge a horse by harness|in harness é€šåŠ›åˆä½œï¼›ç›¸äº’é…åˆ
falcon|n.|éš¼ï¼›çŒé¹°
hawk|n.|é¹°ï¼›éš¼
eagle|n.|é›•
owl|n.|çŒ«å¤´é¹°
swallow|n.|ç‡•å­||å’Œåå’½æ˜¯ä¸€ä¸ªè¯
sparrow|n.|éº»é›€
pigeon|n.|é¸½å­
crow|n.|ä¹Œé¸¦
swan|n.|å¤©é¹…
goose|n.|é¹…ï¼›é¹…è‚‰
cock|n.|å…¬é¸¡ï¼›é›„ç¦½
mouse|n.|è€é¼ ï¼›é¼ æ ‡
rat|n.|è€é¼ ï¼›å‘é„™çš„äºº
squirrel|n.|æ¾æ ‘
hare|n.|é‡å…”
frog|n.|é’è›™
behaviour/behavior|n.| è¡Œä¸ºï¼›æ´»åŠ¨æ–¹å¼
bite|v./n.|å’¬ï¼›ï¼ˆæ˜†è™«ï¼‰å®ï¼›åé¥µ
sting|v./n.|åˆºï¼›å®ï¼›ï¼ˆä½¿ï¼‰æ„Ÿè§‰åˆºç—›ï¼›é³Œé’ˆï¼›èœ‡ç—›|It is the nature of the scorpion to sting|sting sb. into doing sth. åˆºæ¿€æŸäººåšæŸäº‹
bark|v./n.|å ï¼›å¤§å£°åš·ï¼›æ ‘çš®
roar|n./v.|å¼å«ï¼›å’†å“®
rub|v./n.|æ“¦ï¼›æ‘©æ“¦/å›°éš¾ï¼›éšœç¢||the ~ é—®é¢˜ï¼Œå›°éš¾ï¼Œéšœç¢
creep|v.|çˆ¬è¡Œï¼›æ‚„æ‚„åœ°çˆ¬è¡Œ|We take off our shoes and creep cautiously along the passage|creep along æ²¿ç€...çˆ¬è¡Œ
crawl|v.|çˆ¬ï¼›çˆ¬è¡Œï¼›å‘èº¬å±ˆè†ï¼›å·´ç»“
habitat|n.|æ –æ¯åœ°
nest|n.|å·¢ï¼›çªï¼›ç©´
hive|n./v.|èœ‚æˆ¿ï¼›ç¹å¿™çš„åœºæ‰€ï¼›ï¼ˆä½¿ï¼‰å…¥èœ‚ç®±ï¼›ï¼ˆåƒèœœèœ‚èˆ¬ï¼‰å¯†é›†ç¾¤å±…
cell|n.|èœ‚æˆ¿å·¢å®¤ï¼›ç»†èƒï¼›å•äººç‰¢æˆ¿
stable|n./adj.|é©¬å©ï¼›ç‰›æ£šï¼›ç¨³å®šçš„
barn|n.|è°·ä»“ï¼›ç‰²å£æ£š
hedge|n.|æ ‘ç¯±ï¼›éšœç¢ç‰©|There is a opening in the hedge|on the hedge æŠ±éª‘å¢™æ€åº¦çš„
barrier|n.|éšœç¢
bar|n.|æ …ï¼›æ æ†ï¼›æ¡ï¼›é•¿å—
anatomy|n.|è§£å‰–å­¦
epidemic|n./adj.|æµè¡Œç—…ï¼›ï¼ˆåäº‹çš„ï¼‰ç››è¡Œï¼›æµè¡Œæ€§çš„ï¼›æä¸ºç››è¡Œçš„
bacteria|n.|ç»†èŒï¼›bacterium çš„å¤æ•°å½¢å¼
virus|n.|ç—…æ¯’
microbe|n.|å¾®ç”Ÿç‰©
metabolism|n.|æ–°é™ˆä»£è°¢
protein|n.|è›‹ç™½è´¨|You need more protein to build you up
vitamin|n.|ç»´ç”Ÿç´ 
secrete|v.|åˆ†æ³Œ|The kidneys secrete urine|secret n. ç§˜å¯†
excrete|v.|æ’æ³„ï¼›åˆ†æ³Œ|The function of kidneys are excrete waste products
devour|v.|åé£Ÿï¼›ç‹¼åè™å’½çš„åƒ
instinct|n.|æœ¬èƒ½ï¼›å¤©æ€§ï¼›ç›´è§‰
intuitive|adj.|ç›´è§‰çš„
potential|n./adj.|æ½œåŠ›/æ½œåœ¨çš„
intelligence|n.|æ™ºæ…§ï¼›æ™ºåŠ›ï¼›æƒ…æŠ¥ï¼›è°æŠ¥|Use your intelligence, and you're succeed some day|intelligent adj. èªæ˜çš„ã€‚an intelligence agent æƒ…æŠ¥äººå‘˜ã€‚artificial intelligence äººå·¥æ™ºèƒ½
functional|adj.|åŠŸèƒ½çš„ï¼›èµ·ä½œç”¨çš„
sensitive|adj.|çµæ•çš„ï¼›æ˜“æ‹…å¿§çš„ï¼›éœ€è°¨æ…å¯¹å¾…çš„
flexible|adj.|çµæ´»çš„ï¼›å¼¹æ€§çš„
acoustic|adj.|å¬è§‰çš„ï¼›å£°éŸ³çš„
optical|adj.|è§†è§‰çš„ï¼›å…‰å­¦çš„
nocturnal|adj.|å¤œé—´æ´»åŠ¨çš„|Hamsters are nocturnal creatures|hamster n. ä»“é¼ 
dormant|adj.|ç¡ç€çš„ï¼›ä¼‘çœ çš„ï¼›ï¼ˆåŠ¨ç‰©ç­‰ï¼‰å†¬çœ çš„
hibernation|n.|å†¬çœ 
track|v./n.|è¿½è¸ªï¼›è¶³è¿¹ï¼›è¸ªè¿¹ï¼›è½¨é“
trace|v./n.|è¿½è¸ªï¼›æŸ¥å‡ºï¼›è¿½æº¯ï¼›ç—•è¿¹ï¼›å°‘è®¸|They traced the criminal to a house in the city|a trace of å°‘è®¸ï¼›ä¸€ä¸ã€‚track back to è¿½æº¯åˆ°
alternate|v.|ï¼ˆä½¿ï¼‰äº¤æ›¿ï¼›ï¼ˆä½¿ï¼‰è½®æµ|Sunny weather alternated with rain|alternative adj. å¯ä¾›é€‰æ‹©çš„ n. å¯ä¾›é€‰æ‹©çš„äº‹ç‰©
prey|n./v.|çŒç‰©ï¼›æ•é£Ÿ
predator|n.|æ å¤ºè€…ï¼›æ•é£Ÿæ€§åŠ¨ç‰©
victim|n.|å—å®³è€…
captive|n./adj.|ä¿˜è™ï¼›è¢«å…³æŠ¼çš„ï¼›æ”¶æ§åˆ¶çš„
defensive|adj.|é˜²å¾¡æ€§çš„|we took a defensive attitude in the negotiation|defend v. é˜²å«ã€‚self-defensive adj. è‡ªå«çš„
undergo|v.|ç»å†ï¼›ç»å—
suffer|v.|é­å—ï¼›å—æŠ˜ç£¨ï¼›å˜ç³Ÿ
vulnerable|adj.|æ˜“å—ä¼¤çš„ï¼›è„†å¼±çš„
subsistence|n.|å‹‰å¼ºç»´æŒç”Ÿæ´»|The standard of living at that time was on the edge of subsistence å½“æ—¶çš„ç”Ÿæ´»æ°´å¹³å‡ºäºå‹‰å¼ºç»´ç”Ÿè¾¹ç¼˜
exterminate|v.|æ¶ˆç­ï¼›æ ¹é™¤|We've made great efforts to exterminate mosquitoes and flies
tame|v./adj.|é©¯å…»ï¼›åˆ¶æœ/é©¯æœçš„ï¼›ä¹å‘³çš„|The tame lions can communicate and dance together with the actors|tame nature å¾æœå¤§è‡ªç„¶
keeper|n.|çœ‹å®ˆäººï¼›é¥²å…»å‘˜
shepherd|n.|ç‰§ç¾Šäººï¼Œç¾Šå€Œ|The shepherd set out to look for sheep that had wandered away|sheepdog n. ç‰§ç¾ŠçŠ¬
