education|n.|
primary|adj.
secondary|adj.
university|n.
college|n.|学院；大学
institute|n.|研究所
academy|n.|专科院校；（美国的）私立学校；研究会；学会|This is an academy of music|academic adj. 学术的；学院的
learn|v.|学习；得知
study|v./n.|学习；研究
acquire|v.|获得；购得
knowledge|n.|知识
expertise|n.|专门技能
novice|n.|新手|I'm a complete novice at yoga
recruit|v.|吸收（新成员）|The country's first act would be to recruit for the navy
literate|adj.|有读写能力的|Over one-quarter of the adult population are not fully literate|literacy n. 读写能力
illiteracy|n.|文盲
numerate|adj.|识数的；有计算能力的
problem|n.|问题；习题
issue|n./v.|重要问题；发行。公布；发出
affair|n.|事件；公共事件
controversial|adj.|有争议的|They tried to stay away from controversial topics at the dinner party
puzzle|n./v.|难题；谜。使迷惑
riddle|n.|谜；谜语
obscure|adj.|难以理解的|Rules for the game are somewhat obscure
instil/instill|v.| 逐渐灌输|A sense of duty must be instilled in our children
cram|v.|把...塞进；（为应考）临时死记硬背
emphasise/emphasize|v.|强调；着重
enhance|v.|提高；增强|A good score of IELTS enhance my change of getting the offer
enable|v.|使能够
inspire|v.|鼓舞；给...灵感
motive|n.|动机；缘由
motivate|v.|激发；驱使
stimulate|v.|刺激；激励
spur|v./n.|鞭策；激发。马刺；刺激
impetus|n.|推动；促进；动量；惯性|The car ran down the bridge under it's own impetus
indulge|v.|迁就；放任；沉湎；让...享受一下|You can indulge yourself without spending a fortune
spoil|v.|宠坏；溺爱；破坏；糟蹋
abuse|v.|滥用；虐待|It's easy to abuse one's power|alcohol abuse 酗酒
intelligent|adj.|聪明的
clever|adj.|聪明的；精明的
smart|adj.|聪明的；智能的
all-round/all-around|adj.|有多方面才能的；全面的|She is an all-round artist
genius|n.|天才人物；天赋
elite|n.|精英
idiot|n.|白痴；傻瓜
wisdom|n.|智慧；学问
wit|n.|风趣的人；机智；风趣；智慧|Holmes was a gregarious, a great wit, a man of wide interests
aptitude|n.|天生的才能；资质|That student has an aptitude for music|apt adj. 恰当的；聪明的
capable|adj.|有能力的；有才能的|Not everyone is capable of judging fine arts|capability n. 能力。capacity n. 容量。be capable of 能够
excellent|adj.|杰出的；优秀的|She had a high reputation for her excellent detective novels|excel v. 擅长；突出
outstanding|adj.|突出的；杰出的
brilliant|adj.|光辉的；聪明的；（光线等）明亮的
prestige|n.|威望；声望|These new policies will affect the president's national and international prestige|prestigious adj. 有名望的；享有声望的
reputation|n.|名誉；声誉
eminent|adj.|著名的；杰出的|The students are expecting the arrival of an eminent scientist
notorious|adj.|名声狼藉的|The notorious thief was finally caught and put to prison|notoriety n. 坏名声
esteem|v.|尊重；尊敬
respect|n./v.|尊敬；敬重
diligent|adj.|勤勉的；勤奋的
painstaking|adj.|极其仔细的；辛苦的|The mastery of a language requires painstaking effort
skill|n.|技巧
approach|n./v.|方法。接近
scheme|n./v.|计划；方案；阴谋。谋划|All the scheme an intrigues are doomed to failure
headmaster|n.|[英]男校长
principal|n./adj.|[美]（中小学）校长；[英]大学校长；学院院长。首要的|He is going to resign from the position of principal
dean|n.|（大学的）学院院长；系主任
faculty|n.|（大学的）系、院；全体教员
professor|n.|教授
scholar|n.|学者
scientist|n.|科学家
mentor|n.|导师；顾问
tutor|n.|家庭教师；（英国大学或者学院的）导师
lecturer|n.|讲师
assistant|n.|助理；助手
candidate|n.|候选人；求职者；考生
degree|n.|学位；程度|He left without completing his degree|to a certain degree 在某种程度上
qualify|v.|（使）有资格、有权
certify|v.|证明；颁发专业合格证书
license/licence|n.|执照；许可证
permit|n.|许可证
diploma|n.|毕业文凭
diplomat|n.|外交官；善于交际的人
ambassador|n.|大使|He was appointed ambassador to France|embassy n. 大使馆
pupil|n.|小学生；瞳孔|As a girl, she had been a model pupil
graduate|n./v.|毕业生；毕业
ceremony|n.|典礼；礼节
bachelor|n.|学士；单身汉
master|n./v.|硕士；大师。精通；控制
doctor|n.|博士；医生
fresher|n.|[英]（大学）一年级新生
sophomore|n.|[美]（大学或高中）二年级学士
junior|n./adj.|[美]（大学或高中）三年级学生；较年幼者。青少年的；级别（或地位）较低的
senior|n./adj.|[美]（大学或高中）毕业班学士；较年长者。成人的；资深的
alumni|n.|[alumnus 的复数形式]毕业生；校友|My alumni and alumna are present at my birthday party
campus|n.|（大专院校的）校园
orientation|n.|迎新会；方向
platform|n.|平台；讲台
coed/co-educational|adj./n.|男女同校的。（男女同校的大学生中的）女生|A nationwide research is under way for typical coeds
register|v./n.|登记；注册。登记表；注册簿
roster|n.|花名册；登记表；执勤表|I am on the roster for tomorrow night
enrol/enroll|v.|登记；注册；加入
matriculation|n.|注册入大学
accommodation|n.|住处；食宿招待
dorm|n.|宿舍
dining hall|n.|食堂
canteen|n.|水壶；[英]食堂
laboratory/lab|n.|实验室；研究室
experiment|n.|实验；试验
data|n.|[datum 的复数形式]数据
quantity|n.|数量
quality|n.|质量
library|n.|图书馆；个人收藏
literature|n.|文学；文学作品；文献
article|n.|文章
author|n.|作者；作家
tale|n.|故事；传说
fiction|n.|小说；虚构；杜撰
story|n.|故事；小说；（尤指口头的）叙述
diary|n.|日记；日记簿
poetry|n.|诗
magazine|n.|杂志；期刊；弹夹
journal|n.|日报；周报；（尤指专门科学的）杂志；日志
coverage|n.|新闻报道；覆盖范围
bibliography|n.|参考书目
encyclopedia/encyclopaedia|n.|百科全书
biography|n.|传记
documentary|n./adj.|纪录片；记录的
series|n.|连续的；一系列；系列节目
record|n.|记录；履历
file|n./v.|档案；把...归档
profile|n.|概述；人物简介；侧面轮廓
draft|n.|草稿；汇票；起草
sketch|n./v.|概略；概述
brochure|n.|小册子
manual|n.|使用手册；指南；手工的
frame|n.|框架；眼镜框；构架
index|n./v.|指数；索引；为...编索引
catalogue/catalog|n.|目录
category|n.|种类；类别；范畴
inventory|n.|库存；详细目录
content|n./adj.|内容；目录；含量。满足的
context|n.|上下文；语境；背景
list|n./v.|一览表；目录。列举；把...列表
chapter|n.|（书的）章；（人生或历史的）重要时刻
volume|n.|卷；体积；容积；音量
reel|n.|卷轴；卷筒；一卷胶卷
subject|n.|科目；主题；实验对象
object|n./v.|物体；目标。反对
major|n./v./adj.|[美]主修科目；专业。主修。主要的
minor|n./adj.|[美]辅修科目。不严重的|My major is English, but I also have a minor in history.
sociology|n.|社会学|A few years ago, sociology was the most popular subject for undergraduates
politics|n.|政治学；政治；政治事务
economics|n.|经济学
marketing|n.|市场营销
accounting|n.|会计
audit|n./v.|审计。旁听；审计
statistics|n.|统计学
psychology|n.|心理学；心理特征
philosophy|n.|哲学
logic|n.|逻辑学；逻辑
biology|n.|生物学；生命机理
physics|n.|物理学
chemistry|n.|化学
agriculture|n.|农业；农学
logistics|n.|物流；后勤
geography|n.|地理学；地形；地势
history|n.|历史；历史学
engineering|n.|工程；工程学
mechanics|n.|力学；机械学
electronics|n.|电子学；电子器件|That country wants to increase tariffs on items such as electronics|electron n. 电子。electronic adj. 电子的；电子学的。electrical adj. 电的；电气科学的。electricity n. 电；电流；电学
maths/mathematics|n.|数学
arithmetic|n.|算数
geometry|n.|几何学
algebra|n.|代数
calculus|n.|微积分；结实
plus|prep./adj.|加上。正数的；在零以上的
sum|n.|总和；总数；金额
total|adj./n.|总的；全部的。总数
merger|n.|合并；并归
equation|n.|相等；平衡；综合体；方程式；等式
identical|adj.|同一的|This is the identical hotel we stayed at last year
minus|adj./prep.|负的；零以下的；减去
subtract|v.|减去；减
multiply|v.|乘；使相乘；使成倍增加；繁殖
divide|v.|除以；除
dividend|n.|被除数
remainder|n.|余数；剩余部分
rational|n./adj.|有理数；（数、式等）有理的
parameter|n.|参数；起限定作用的因素
variable|n./adj.|变量；可变因素。易变的
even|adj./adv.|均匀的；偶数的；相等的。甚至
odd|adj.|奇数的；古怪的
mean|n./adj.|平均数；平均值。平均的|The professor asked the students to take 200 values and calculate the mean|mean distance 平均距离
double|adj./n./v.|两倍的。两倍数；两倍量。使加倍
triple|adj./n./v|三倍的；三重的。三倍数；三包两。使增至三倍
quadruple|adj./n./v.|四倍的。四倍
multiple|n./adj.|倍数。多样的，数量多的
maximum|n.|最大值；最大限度
minimum|n.|最小值；最小限度
approximately|adv.|大约
chart|n.|图；图表；海图
graph|n.|图表；图
diagram|n.|图表；示意图；图解
table|n.|表格；桌子
matrix|n.|矩阵；铸模
rectangle|n.|长方形；矩形
cube|n.|立方体；立方；三次幂；立方的东西
angle|n.|角度；脚
triangle|n.|三角形；三角关系
diagonal|adj./n.|斜纹的；对角线的。对角线；斜纹织物
straight|adj./adv.|直的；笔直地；直接
circle|n.|圆
round|adj./n./adv.|圆的。绕圈；一轮。环绕
dot|n./v.|点。在...打点
sphere|n.|球体；球状物；范围；领域|We move in different social sphere
cone|n.|圆锥体；锥形物|The police have sectioned off the road with traffic cones
extent|n.|广度；范围；程度|No one cares about the extent of his debts|to some extent 在某种程度上
width|n.|宽度
length|n.|长度
decimal|adj./n.|小数的；十进制的。小数
percent/per cent|n.|百分之...
proportion|n.|比例
rate|n.|比率；率；速度
ratio|n.|比|The ratio of 3 to 9 is the same as that 9 to 27|in direct ratio 按正比例。in inverse ratio 按反比例
fraction|n.|分数；小部分；片段|She spends only a fraction of her earnings on clothes
scale|n./v.|刻度；规模。攀登 scales 天平；鳞
ounce|n.|盎司；少量
density|n.|密度；浓度
Fahrenheit|adj.|华氏温标的
mercury|n.|水银；水星
battery|n.|电池；（物品的）一组
volt|n.|伏特
radiate|v.|辐射；发散；从中心向四周散开
emit|v.|散发 (光、热、气等)；发出（声音）|The tail exhaust pipe of the car emitted poisonous smoke
transparent|adj.|透明的；易看穿的
hollow|adj.|中空的；空心的
ozone|n.|臭氧
gravity|n.|地球引力；重力
friction|n.|摩擦力；摩擦；不和；矛盾
eccentric|adj.|不同心圆的；古怪的|The old lady has some eccentric habits
displace|v.|移动...的位置；取代；代替|A bone in his knee was displaced when he crashed against another player
boil|v./n.|煮沸。沸点|The watched pot never boils 性急烧水不沸|boil down to 归结为。on the boil 在沸腾
melt|v.|（使）融/熔化
dissolve|v.|（使）溶解；解散
rust|v./n.|（使）生锈。锈；铁锈|If you leave your metal tools outside in the rain, they will rust|rusty adj. 生锈的
ferment|v./n.|（使）发酵；骚动。酶；发酵；动乱|The whole country was in a state of ferment|yeast n. 酵母；酵母菌
dilute|v./adj.|冲淡；稀释。稀释了的；减弱了的|The nurse diluted the drug with saline water
acid|n./adj.|酸。酸的；讽刺的；尖刻的
noxious|adj.|有害的|Increasing tax on petrol would encourage people to drive cars with fewer emissions
static|adj.|静态的
inert|adj.|无生气的；惰性的；不活泼
inherent|adj.|内在的；固有的|Polarity is inherent in a magent|be inherent in 为...所固有
formula|n.|公式；方程式；原则；配方；分子式
component|n.|成分；组成
compose|v.|组成；构成；创作；写|Water is composed of hydrogen and oxygen|composer n. 作曲家。be composed of 由...组成
mixture|n.|混合物
blend|n./v.|混合；（使）交融。混合物
theory|n.|理论；学说
empirical|adj.|经验主义的；以实验为依据的|His thesis is not very convincing for lack of empirical evidence
practical|adj.|实际的；有用的；务实的；心灵手巧的
doctrine|n.|学说；教义；信条
principle|n.|原则；（科学）原理
discipline|n.|纪律；训练
term|n.|期限；术语；[英]学期
semester|n.|学期
timetable|n.|时间表；课程表
schedule|n.|日程安排；[美]时刻表
deadline|n.|截止日期
course|n.|课程
lesson|n.|一堂课；课程；教训
curriculum|n.|课程；全部课程|The staff should work together to revise the school curriculum|extra-curriculum 课外的。curriculum vitae 履历 CV
seminar|n.|研讨会；讨论课
forum|n.|论坛；讨论会；公开讨论广场
syllabus|n.|教学大纲
system|n.|系统；体系；制度
rudimentary|adj.|基本的；粗浅的
basic|adj.|基本的；基础的
fundamental|adj.|基础的；基本的；根本的
elementary|adj.|基本的；初级的
profound|adj.|（影响）深刻的，深远的；见解深刻的|His brother's words have had a profound effect on him
superficial|adj.|表面的；外表的；肤浅的
surface|n.|表面；地面；水面
compulsory|adj.|强制的
prerequisite|n./adj.|必备条件。必备的
selective|adj.|选择性的
elective|adj.|选择性的
assignment|n.|作业；任务
submit|v.|提交；服从||submit to 服从于；屈从于。submit sth. to 把某物提交给
preview|n./v.|预习
review|n./v.|回顾；复习
revise|v.|修订；修改
inspect|v.|检查；检阅；视察
consult|v.|请教；查阅
skim|v.|掠过；擦过；略读
scan|v./n.|细看；浏览；扫描
scrutinise/scrutinize|v.|仔细检查|scrutiny n. 详细审查
recite|v.|背诵；朗诵
dictate|v.|让（某人）听写；命令；强行规定|The English teacher dictates to the class every other week|dictaion n. 听写；口述
examination/exam|n.|考试；抽查
test|v./n.|测试；检验
quiz|n.|小测验
presentation|n.|陈述；表演；演出
plagiarise/plagiarize|v.|抄袭
copy|n./v.|复制品。抄写；复制
print|v./n.|打印。印刷品；照片
thesis|n.|论文
essay|n.|短文；小品文
paper|n.|论文；纸
dissertation|n.|专题论文；（尤指）学位论文
project|n.|（大中学生的）专题研究；项目；方案
heading|n.|标题；主题
outset|n.|开端；开始
outline|n.|概要；轮廓
point|n.|点；要点
gist|n.|主旨；要点|He cannot understand the gist of their argument
opinion|n.|看法；评价
introduce|v.|介绍；引进
reference|n.|参考；推荐函；提及；涉及
cite|v.|引用
elicit|v.|引出；探出；套出
quote|v.|引用；引述；报（价）
extract|n.|摘录
abstract|n./adj./v.|摘要。抽象的。提取；把...抽象出
summary|n.|摘要；概要
assume|v.|假定；设想；承担（责任）；取得（权力）||assumption n. 假设；假想
presume|v.|假定；假设；料想
suppose|v.|假定；认为|Let us suppose another planet with conditions similar to those on the earth|be suppose to do sth. 应该做某事
hypothesis|n.|假说；假设
postulate|v./n.|假定；假设
speculate|v.|推测
predict|v.|预测
perceive|v.|感知；察觉；意识到|I perceived that it was not possible to make her change her mind
detect|v.|察觉；发觉；侦查出
discern|v.|察觉出；分辨出
recognise/recognize|v.|认识；辨认出
conscious|adj.|意识到的；有知觉的
reckon|v.|估计；期望；认为
deem|v.|认为；相信
imply|v.|暗指；意味着
deliberate|v./adj.|深思熟虑；仔细考虑。审慎的
represent|v.|代表；象征
insist|v.|坚持；坚决认为（主张或要求）
persist|v.|坚持不懈；持续存在
understand|v.|懂得；理解
comprehend|v.|理解；领悟
analyse/analyze|v.|分析
diagnose|v.|判断；诊断
infer|v.|推断；推理
deduce|v.|演绎；推论
conclude|v.|推断出；得出结论；（使）结束
analogy|n.|类比；类推||analogous adj. 类似的。by analogy 通过类推法
compare|v.|比较；把...比作；比得上
contrast|n.|对比；明显的差异||by contrast/in contrast 与之相比，相比之下。in contrast to 与...截然不同
overlap|v.|与...复叠；（与...）部分相同
contradiction|n.|矛盾；不一致；反驳
disagree|v.|有分歧；不同意
differ|v.|不同、相异||differ from 与...不同
diverse|adj.|不一样的；多种多样的
nuance|n.|细微差别
inductive|adj.|归纳的；诱导的
detail|n.|细节；（画等的）细节||detailed adj. 详细的。in detail 详细地
thorough|adj.|彻底的；详尽的
example|n.|例子；榜样
instance|n.|实例；情况；场合||for instance 例如
confirm|v.|证实；确保；巩固
demonstrate|v.|示范；演示；证明||demonstration n. 示范；游行示威。demonstrative adj. 情感外露的；喜怒形于色的。demonstrator n. 示范者；游行示威者
illustrate|v.|（用图等）说明；给（书）加插图（或图表）
manifest|v.|显示；表明
prove|v.|证明；结果是
determine|v.|决定；下定决心；查明||determinant n. 决定因素。 determined adj. 下定决心的。determine to do sth. 决心做某事。determine beforehand 事先决定
decide|v.|决定||decision n. 决定；抉择
resolve|v.|决心；决定；（使）分解为；解决||resolution n. 决心；分辨率。solution n. 解决方案；溶液
survey|n./v.|民意调查；对...进行民意调查||动词的时候重音在中间
research|n.|调查；探索
observe|v.|观察；观测；注意到
inquire/enquire|v.|询问；调查||inquiry n. 询问；调查。 inquire into 调查
query|n./v.|疑问；询问；怀疑；询问
questionnaire|n.|调查表；调查问卷
achieve|v.|实现；到达||achievement n. 成就；完成；达到。achieve success 取得成功
accomplish|v.|达到（目的）；完成
attain|v.|获得；达到||attainment n. 达到；成就。attain one's goal 达到某人目标
credit|n.|赊购；学分；信任
score|n.|得分、成绩
mark|n./v.|分数；标记；标志着；给...打分；在...上做记号
grade|v./n.|给...分等级：等级；成绩等级
rank|n./v.|等级；排；列；给...评级；位列||ranking n. 排名（表）；等级
row|n.|一排；一行
queue|n./v.|行列；队列；排队等候
grant|v.|授予；准予；承认||take sth. for granted 认为某事是理所应当的
praise|n./v.|赞美；赞扬||full of praise 赞不绝口 praise sb. for sth. 为某事赞扬某人
appreciate|v.|赏识；感激；意识到
feedback|n.|反馈；反应
underestimate|v.|低估||estimate v. 估算；n. 估算；评价
overestimate|v.|高估
apply|v.|申请
fellowship|n.|研究生奖学金
scholarship|n.|奖学金；学问；学识
reward|n./v.|报答；赏金；报答||reward sb. for sth. 为某事报答某人。 as a reward for 作为对（某事）的报酬
award|n.|奖；奖品
prize|n./v.|奖赏；珍视
fee|n.|酬金；费用
