medium|n./adj.|媒介；中间的；中等的
press|n.|新闻界；记者；报刊；出版社
journalist|n.|记者；新闻工作者
critic|n.|批评家；挑剔的人||critical adj. 批评的；挑剔的。criticism n. 批评；职责。criticise=criticize v. 批评。a movie critic 影评人
commentator|n.|评论员；实况解说员
exponent|n.|阐述者；倡导者；拥护者
announcer|n.|广播员；播音员
correspondent|n.|通信者；通讯员；记者
messenger|n.|邮递员；信使
editor|n.|编辑；校订者
typist|n.|打字员
handout|n.|传单；讲义
leaflet|n./v.|传单；散发传单
propaganda|n.|宣传；鼓吹
publish|v.|公布；出版；发行
disseminate|v.|散布；传播
foresee|v.|预见；预知
anticipate|v.|预期；预料||participate v. 参与
expect|v.|预料；期待||expectation n. 期待；期望
await|v.|等候；期待；将降临到...身上
pastime|n.|娱乐；消遣
entertain|v.|娱乐；招待；心存；怀有||entertainment n. 娱乐；消遣；款待
recreation|n.|休闲；娱乐||a recreation ground 公共娱乐场
amuse|v.|逗乐；给...提供娱乐||amuse oneself 自娱自乐
gossip|n.|闲聊；流言蜚语
rumour/rumor|n.|谣言；传闻
consensus|n.|共识；一致的意见
festival|n.|节日
feast|n.|盛宴；（宗教）节日
programme/program|n./v.|节目；方案；程序；为系统设置程序；计划||programmer n. 程序设计员
rehearsal|n.|排练
perform|v.|表演；演出
imitate|v.|模仿；效仿
mimic|v.|模仿；戏仿
simulate|v.|模拟；假装；冒充||simulative adj. 模拟的；假装的
circus|n.|马戏团；圆形广场（常用于地名）||a circus clown 马戏团小丑
magic|n.|魔术；魔法
drama|n.|戏；剧；戏剧艺术
concert|n.|音乐会||musicale n. 社交音乐会。concertmaster n. 首席小提琴手。concertgoer n. 常去听音乐会者。concerto n. 协奏曲。conductor n. （乐队、合唱团）指挥。melody n. 旋律。rhythm n. 节奏。lyrics n. 歌词。score n. 总谱。in concert with 与...合作
symphony|n.|交响乐
orchestra|n.|管弦乐队
ballet|n.|芭蕾舞；芭蕾舞剧
opera|n.|歌剧
comedy|n.|喜剧
tragedy|n.|悲剧；悲惨的事
animation|n.|动画片；动画制作
film|n.|影片；胶卷
movie|n.|电影
X-rated|adj.|X级的；青少年不宜的
artist|n.|艺术家
craftsman|n.|工匠；工艺师
painter|n.|画家；油漆匠
role|n.|角色
scene|n.|景色；现场；（戏剧的）场面
stage|n.|舞台；阶段||the stage 戏剧演出
gallery|n.|美术馆
exhibition|n.|展览
aesthetic/esthetic|adj./n.|审美的；审美观
collect|v.|收集；收藏
select|v./adj.|选择；挑选；精选的
opt|v.|选择||option n. 选择；选择权。 opt for sth. 选择某事物
photograph|n.|照片；相片
portrait|n.|肖像；半身画像
painting|n.|油画；会话；画作；涂漆
sculpture|n.|雕塑
draw|v.|画；拉；拔出
sketch|n./v.|素描；草图；速写；画素描；画速写
depict|v.|描述；描写；描绘
describe|v.|描述；形容
carve|v.|雕刻；切下
improvise|v.|临时做；即兴创作||improvisation n. 即兴创作
musical|adj.|音乐的；悦耳的
classical|adj.|古典的；传统的
jazz|n.|爵士乐
rock|n.|摇滚乐；岩石
hip-hop|n.|嘻哈文化
pop|n.|流行音乐；流行乐曲
lyric|n./adj.|抒情诗；抒情的
band|n.|乐队；带；波段
solo|n./adj.|独奏；独唱；独奏的；独唱的
melody|n.|乐曲；旋律
rhythm|n.|节奏；韵律|I can't dance to music without good rhythm
tone|n.|音色；声调；腔调
tune|n./v.|曲调；短乐曲；调试
disc/disk|n.|光碟；唱片；磁盘
piano|n.|钢琴
violin|n.|小提琴
cello|n.|大提琴
guitar|n.|吉他
harmonica|n.|口琴
trumpet|n.|喇叭；小号
drum|n.|鼓；鼓状物；大桶
flute|n.|长笛
competition|n.|竞争；比赛||compete v. 竞争。competitor n. 竞争者
tournament|n.|锦标赛；联赛
Olympic|adj./n.|奥林匹克运动会
sponsor|n./v.|发起人；主办人；赞助人。发起；主办；赞助
patron|n.|赞助人；顾客；老主顾
athlete|n.|运动员
champion|n./v.|冠军；第一名；拥护；支持
spectator|n.|观众
volunteer|n./v.|志愿者；自愿做
famous|adj.|著名的；出名的||fame n. 名声。be famous for 以...闻名
well-known|adj.|众所周知的；出名的
energetic|adj.|充满活力的；精力充沛的
vigorous|adj.|充满活力的；活跃的；积极的
stadium|n.|体育场；运动场
gym|n.|体育馆；运动场
training|n.|训练；锻炼；培训
exercise|n./v.|锻炼；运动；习题；练习。锻炼
indoor|adj.|室内的||indoors adv. 在室内
outdoor|adj.|户外的；室外的
motion|v.|做动作；示意
mobile|adj.|可移动的；流动的
movement|n.|活动；运动；移动
yoga|n.|瑜伽
sprawl|n./v.|延伸；蔓延。（城市）杂乱无序扩张的地区
stretch|v.|延伸；伸长
strain|v./n.|拉紧；拉伤；扭伤。张力；拉力；（精神上）紧张
chess|n.|国际象棋
badminton|n.|羽毛球
golf|n.|高尔夫球
billiards|n.|台球
soccer|n.|（英式）足球
tennis|n.|网球
volleyball|n.|排球
hockey|n.|曲棍球；冰球
cricket|n.|板球
goal|n.|球门；进球得分；目的
bat|n.|球拍；球棒；球板
racket|n.|（网球、羽毛球）球拍
kick|n./v.|踢
knock|v.|敲；击；撞
flip|v./n.|掷；快速翻转。随便的；宽泛的
pitch|v./n.|投；掷；球场；（棒球中的）投球|She pitched the ball as far as she could|invade the pitch 涌进球场。throw a pitch 投球
throw|v.|投；掷；抛；扔
toss|v.|扔；抛；掷；（使）颠簸
slide|v./n.|滑动；逐渐降低；滑行；下跌
slip|v./n.|滑跤；滑落；溜；滑到|She slipped and fell down the stairs|a slip of the tongue 口误；失言
glide|v./n.|滑动；掠过；滑行
tumble|v.|摔倒；滚下
ski|v./n.|滑雪；滑雪板
skate|v.|滑冰
cycling|n.|骑自行车运动
dive|v.|跳水；潜水；俯冲
drift|v.|飘逸；漂流；流浪；漂泊||drift from one country to another 从一国流浪到另一国
jump|v.|跳；暴涨；跳过||from the jump 从一开始
leap|v./n.|跳；跃；跳跃
plunge|v./n.|纵身投入；猛跌；（使）投身。跳水；猛跌||plunge whole-heartedly 全心全意的投入
spring|v./n.|跳；跃
hop|v.|跳上/下；单脚跳行；齐足跳行
bounce|v.|（使）反弹/弹起/跳动
tent|n.|帐篷
camp|n.|营地；阵营
picnic|n./v.|野餐；野餐食物||go for a picnic
hunt|v./n.|打猎；搜寻；猎取||hunter n. 猎人。hunt for 寻找
race|n.|赛跑；速度竞赛；人种；种族
marathon|n.|马拉松
pedestrian|n.|步行者；行人|In the accident a pedestrian and a cyclist were injured|a pedestrian crossing 人形横道
pace|n./v.|步速；速度；步调；节奏；来回踱步
step|n.|步伐；步骤||footstep n. 脚步声；足迹。step by step 一步一步；逐步
excursion|n.|远足；短程旅行
cruise|v.|乘船游览；以平稳的速度行驶||cruiser n. 巡洋舰；舱式游艇；巡逻警车
trip|v./n.|绊倒；旅行
vacation|v./n.|休假；假期
hike|n./v.|徒步旅行；远足
jog|v.|慢跑||jogger n. 慢跑锻炼的人。jogging n. 慢跑
stride|v.|大步走；阔步行走|They are strading forward both in English and in Mathematics
wander|v.|闲逛；漫步；走神；开小差
linger|v.|逗留；流连；继续存留|We linger at the beach whole summer
lag|v./n.|落后；间隔；时间差||lag behind sb./sth. 落后于某人/某物
climb|v.|攀登；爬
pull|v.|拉；拖；扯；划（小船）
drag|v.|拖；拉；拽
bend|v.|俯身；弯腰；使弯曲
bow|v./n.|鞠躬||take a bow
