stuff|n.|东西；原料
item|n.|一件物品；一件商品
merchandise|n.|商品
souvenir|n.|纪念品
artifact/artefact|n.|人造物品；手工艺品
material|n./adj.|材料；原料；人才；物质的
raw|adj.|天然的；未经加工的；（感情）原始的
crude|adj.|天然的；未经加工的；粗超的
necessity|n.|必需品；必要||necessary adj. 必须的；必要的
outfit|adj./n.|全套服装；全套装备；配备；装备
kit|n.|成套工具
utensil|n.|（家庭）用具；器皿
garbage|n.|（尤美）垃圾；废物
rubbish|n.|（尤英）垃圾；废弃物；废话||clear away the rubbish 清除垃圾
trash|n.|（美）垃圾
recycle|v.|使再循环；回收利用
reuse|v.|再次使用
litter|n./v.|垃圾；废弃物；乱丢东西
waste|n./v.|废物；浪费
junk|n.|无用的东西；废物
landfill|n.|垃圾填埋地；垃圾填埋
sewerage|n.|排水系统；污水处理系统；（=sewage）污水
detergent|n.|洗涤剂
lotion|n.|洁肤乳；润肤乳
shampoo|v./n.|用洗发剂（头发）；洗发剂
soap|n./v.|肥皂；用肥皂擦洗
tub|n.|桶；盆；（美）鱼缸；浴盆
plug|n./v.|塞子；插头；把...塞住
tap|n.|旋塞；龙头|He rigged a rubber hose to tap in kitchen|和轻拍是一个单词。 rig v. 安装；装配
pipe|n.|管子；管道；烟斗
tube|n.|管；显像管；（英国/伦敦）地铁
mop|n./v.|拖把；用拖把擦
broom|n./v.|扫帚；用扫帚扫|She used a broom to sweep up the scraps of paper|scrap n. 碎片，碎屑 ~ paper 废纸
sweep|v.|打扫；（迅猛的）吹走；掠过||sweep the board 囊括所有奖项
mattress|n.|床垫
carpet|n.|地毯||red carpet （迎接贵宾用的）红毯
rug|n.|小地毯；（盖肩或腿的）小毛毯
mat|n.|地垫
cushion|n.|软垫|She plumps up the sofa cushion 她把沙发垫拍得鼓鼓的|plump adj./v. 丰满的；饱满的；发福的/使丰满；使鼓起。 ~ sth. up 鼓起，变丰满。 a back cushion 靠背垫。a sofa cushion 沙发垫
pad|n./v.|衬垫；便签本；（用软材料）填塞
blanket|n.|毛毯；毯子|She huddled herself in the blanket|huddle v. 蜷缩；缩成一团
quilt|n.|被子|If you air your quilt on such a wet day, it'll soak up the moisture|晾，这里用的 air。soak sth. up 吸收，吸掉（液体）
sheet|n.|被单；床单；一张（纸）；薄板
pillow|n.|枕头
sponge|n.|海绵
towel|n.|毛巾
staple|n.|订书钉；主要部分
nail|n./v.|指甲；钉子；（用钉子）钉住
razor|n.|剃刀；（用剃刀）剃||an electric razor 电动剃须刀
shave|v.|剃须；刮脸|I lathered my face and started to shave|lather n./v. 肥皂泡/形成泡沫；在...涂皂泡
fuse|n./v.|保险丝；导火线；（使）融化、融合
cable|n.|电缆；缆绳；电报；有线电视|a cable car 缆车
cord|n.|细绳；粗线；（体内的）线、索、带||vocal cords 声带
strand|n.|缕，股；滨，岸|One strand of silk doesn't make a thread 单丝不成线
match|n./v.|火柴；比赛；匹配的人或物；与...匹配
candle|n.|蜡烛
wax|n.|蜡；蜂蜡
portfolio|n.|文件夹；公事包||briefcase n. 公事包
paperback|n.|简装书；平装书
pamphlet|n.|小册子
tissue|n.|面巾纸；（器官）组织
cover|n.|封面；盖子；套子
Xerox|n.|施乐复印机
duplicate|v./n.|重复；副本；复制品
memorandum|n.|备忘录；建议书；=memo
stationery|n.|文具；信纸
glue|n.|胶水
ink|n.|墨水
rubber|n.|（英）橡皮擦；橡胶
scissors|n.|剪刀
shear|n./v.|shears（尤指修篱笆用的）大剪刀；剪
edge|n.|边；边缘；刀口
rim|n.|（圆形物品的）外缘、边缘
element|n.|元素；组成部分；基本部分
factor|n.|因素；要素
section|n.|部分；章；节
tag|n.|标签；称号
label|n.|标签；标贴
badge|n.|徽章；证章；标志；象征
bolt|n./v.|螺栓；插销；闩上（门、窗）
knob|n.|球形把手；旋钮
handle|n./v.|柄；把手；拿；处理
shutter|n./v.|百叶窗；快门；停止（营业）
curtain|n./v.|窗帘；幕布；给...装上帘子
pane|n.|（一块）玻璃窗
opacity|n.|不透明性||opaque n. 不透明物体；adj. 不透明的
jar|n.|罐；广口瓶；猛烈震动
barrel|n.|桶
bucket|n.|（有提手的）桶
pail|n.|（尤美-通常是金属或者木质的）桶；提桶
phone|n.|电话
bell|n.|钟，铃
camera|n.|照相机
portable|adj.|手提式的；便携的
spotlight|n.|聚光灯
lantern|n.|提灯；灯笼
bulb|n.|电灯泡；球茎；球茎状物
flashlight|n.|闪光灯的闪光；手电筒
refrigerator|n.|冰箱
fridge|n.|冰箱|The butter will soften out of the fridge
vacuum|n./adj.|真空；真空吸尘器；真空的
fan|n./v.|扇子；风扇；狂热爱好者；扇
switch|n./v.|开关；转换；
hurdle|n.|栏架；跨栏赛跑
fence|n.|栅栏；围栏
pedal|n./v.|踏板；踩踏板|One of the pedals has come out off my bicycle
shelf|n.|架子；隔板
ladder|n.|梯子；阶梯
lift|v./n.|提；抬；提高；（英）电梯（美 elevator）
stool|n.|凳子
drawer|n.|抽屉
umbrella|n.|伞
raincoat|n.|雨衣
dredge|n./v.|挖泥船；挖掘机/挖掘；撒（糖；面粉等）
can|v./n.|把（食品）罐装保存；罐头；听
mill|n./v.|磨粉机；磨坊/碾碎；无目的地乱转
forge|n./v.|炼铁炉；锻造；伪造
alloy|n.|合金；（金属的）成色
metal|n.|金属
iron|n./v.|铁；熨斗；熨；烫
lead|n.|铅
brass|n.|黄铜；黄铜制品
bronze|n.|青铜；青铜艺术品
cement|n./v.|水泥；胶结剂；使黏结
pitch|n.|沥青
lime|n.|石灰
plaster|n.|灰泥；熟石膏
leather|n.|皮革；皮衣
plastic|n./adj.|塑料；有塑性的；塑料的
fiber/fibre|n.|纤维；纤维素
fabric|n.|织物；布料
knit|v.|编织；针织
weave|v.|编织；编造
canvas|n.|帆布；油画布
linen|n.|亚麻布；亚麻织品
cotton|n.|棉；棉线；棉布
nylon|n.|尼龙
lumber|n.|木材；木料
wooden|adj.|木制的；呆板的
mine|n.|矿场；矿井；地雷
pit|n.|深坑；煤矿；潜在危险
fuel|n./v.|燃料；给...加燃料||add fuel to 给...加燃料
lubricate|v.|润滑；加润滑油于
diamond|n.|金刚石；钻石；菱形
crystal|n.|水晶；结晶；晶体
inferior|adj./n.|差的；下级的；低等的；级别/地位低的人；次品||inferiority
counterfeit|adj./v.|假冒的；伪造
fake|adj./n.|假冒的；冒充者；假货
fragile|adj.|易碎的；脆弱的
miniature|adj./n.|微型的；很小的/微缩模型；微型画
available|adj.|可获得的
durable|adj.|耐用的；持久的
