fashion|n./v.|时尚；制作；制成||fashionable adj. 流行的。come into fashion 流行起来；开始流行。out of fashion 过时的
style|n.|风格；样式；时尚||stylish adj. 时髦的；有格调的
trend|n.|趋势；倾向
tendency|n.|趋势；倾向；偏好
current|n./adj.|潮流；趋势；当前的
popularity|n.|流行|That record made the singer's popularity boom 那张唱片捧红了这位歌手
vogue|n.|流行||in vogue 流行的
prevail|v.|盛行；获胜||prevalence n. 流行；普遍存在。prevailing adj. 盛行的。prevail over/against 压倒；战胜
model|n./v.|模型；模特/使模仿|After a brief spell as a model, she got into singing|spell n. 作名词有“（持续的）一段时间”的意思
icon|n.|偶像；图标
idol|n.|偶像；受到崇拜的人或物；神像
luxury|n.|奢侈；奢侈品||luxurious adj. 奢侈的；豪华的
extravagant|adj.|奢侈的；过分的
jewelry/jewellery|n.|珠宝；手势
jewel|n.|宝石
gem|n.|宝石；珍品
jade|n.|玉石；翡翠
adorn|v.|装饰；装扮
ornament|n./v.|装饰品；装饰|Clearness ornaments profound thought 清晰性能为深刻的思想增辉|
embellish|v.|修饰|The door of the old church was embellished with intricate carvings|intricate adj. 错综复杂的；复杂精细的；难理解的；难解决的。carving n. 雕刻品；雕刻图案；雕刻技艺
embroider|v.|对（故事等）加以渲染；在...上刺绣
hairdressing|n.|美发；理发
pigment|n.|色素；颜料
dye|n.|染料；（染上的）颜色；染
masquerade|n./v.|化装舞会；化妆；假扮
veil|n.|面纱；遮蔽物
costume|n.|戏服；（某历史时期或某地的）服装||academic costume 学位服；a costume ball 化装舞会
fascinate|v.|迷住||fascinating adj. 迷人的。be fascinated with 迷上
decent|adj.|得体的；尚好的|He made a decent record 他成绩善佳|indecent adj. 下流的
exquisite|adj.|精致的；雅致的
grace|n.|优美；优雅|She was a beautiful girl with the grace and poise of a natural model 她是一个美丽的女孩，天生有着模特的那种优雅仪态|poise n. 沉着，泰然自若；平衡
elegance|n.|文雅；典雅||elegant adj. 优雅的
perfect|adj.|完美的
appearance|n.|外貌；出现||appear v. 出现
cosmetics|n.|化妆品
make-up|n.|化妆品；组成成分；性格||make up 化妆
handsome|adj.|数量大的；英俊的
charming|adj.|迷人的||Prince Charming白马王子
pretty|adj./adv.|漂亮的；相当地
beautiful|adj.|美丽的
ugly|adj.|丑陋的
dress|n.|衣服；连衣裙
clothe|v.|给...穿衣；为...提供衣服||clothes n. 衣服。clothing n. 衣服
uniform|n./adj.|制服；一致的
garment|n.|（一件）衣服
laundry|n.|洗衣店；要（或正在）洗的衣服；刚洗好的衣服||do/hang/iron the laundry 洗/晾/熨衣服
wardrobe|n.|衣柜；（某人的）全部服装
overall|n./adj.|（英）（工作时穿的）罩衣；全面的
overcoat|n.|大衣
robe|n.|长袍；浴袍
gown|n.|长外衣；女礼服|She put on her silk gown and went to the ball|ball n. 除了球还有舞会的意思
sweater|n.|毛衣；线衣
jacket|n.|夹克衫
skirt|n.|裙子
jeans|n.|牛仔裤
trousers|n.|（尤英）裤子
clasp|n./v.|搭扣；扣住
button|n./v.|纽扣；按钮；扣上...的纽扣||unbutton v. 解开...的纽扣；如解开纽扣一样解开
glove|n.|手套
hat|n.|（常指带帽檐的）帽子
cap|n.|（有帽舌的）帽子；（经费等的）最高限额
brim|n.|边缘；帽檐|He drank at the fountain's brim|drink 现在分词 drinking，过去式 drank 过去分词 drunk 或 drank。fountain n. 泉水;（尤指具有装饰效果的）喷泉
scarf|n.|围巾；头巾
handkerchief|n.|手帕
purse|n.|（英）钱包；（美）小手提包
wallet|n.|钱包；皮夹子
vest|n.|英-汗衫；美-西装背心
wrap|n.|披肩|Over her shoulders was a much-mended wrap 她的肩上搭着一条被多次缝补的披肩|mend v./n. 修理；修补；缝补/修补过的地方
cloak|n.|斗篷；覆盖物
collar|n.|衣领；项圈
sleeve|n.|袖子
sock|n.|短袜
stocking|n.|（女式）长筒袜
slipper|n.|拖鞋|No slipper is allowed in the laboratory|laboratory n. UK  /ləˈbɒr.ə.tər.i/ US  /ˈlæb.rə.tɔːr.i/ 实验室，实验大楼
boot|n.|靴子
lace|n.|鞋带|He stopped to tie the laces of his sneakers|sneakers(UK trainer) n. 运动鞋 UK trainer
tailor|n./v.|裁缝；专门制作
sew|v.|缝补；缝制
spin|v./n.|纺；（使）旋转；高速旋转；（乘车）兜风
stitch|n./v.|针脚；缝
needle|n.|针
pin|n./v.|别针；大头针；别住，钉住
string|n.|线；一串
thread|n.|线；螺纹
strap|n./v.|带子；用带子系
stripe|n.|条纹
ribbon|n.|缎带；丝带
belt|n.|腰带，皮带；地带，地区
chain|n.|链子；链条
bracelet|n.|手镯
necklace|n.|项链
bead|n./v.|珠子，（液体的）小滴；形成珠状
textile|n./adj.|纺织品；纺织的
velvet|n.|丝绒；天鹅绒
wool|n.|（羊等的）毛；毛线|He found a job of shearing wool from sheep|woollen=woolen adj. 羊毛的
patch|n./v.|补丁，（与周围不同的）小片；补缀|She sewed a patch onto the knee of the trousers 她在裤子的膝部缝了个补丁|patchwork n. 拼布工艺；混杂物
rag|n.|破布|She wrapped the box with an old rag|ragged adj. 破旧的
shabby|adj.|破旧的；衣衫褴褛的
tight|adj.|紧的
colour/color|n.|颜色；颜料|Due to the use of nature pigments, these folk paintings retain their color well. 因为使用了天然颜料，这些民俗画的颜色很好地保留了下来|retain [formal]v. 保持；保留；保有；留住；容纳。colorful=colourful adj. 富于色彩的
white|adj./n.|白的；白色|He was white with fury 他气的脸色发白|whitewash v. 粉刷，刷石灰水
yellow|adj./n.|黄的；黄色
brown|adj./n.|褐色的；褐色
grey/gray|adj./n.|灰色的；灰色
pink|adj./n.|粉色的；粉色
purple|adj./n.|紫色的；紫色
tan|adj./n.|棕黄色的；棕黄色；晒成的棕褐色
fade|v.|逐渐消失；（使）褪色
stain|v./n.|污染；污渍||stainless adj. 无瑕疵的；不锈钢的
blot|n.|污点
figure|n./v.|身材；身影；重要人物；数字；认为||figure out 理解；弄明白。a slender/slim figure 苗条的身材；a hourglass figure 沙漏身材
slender|adj.|苗条的；微弱的
slight|adj.|纤细的；轻微的|Our army suffered a slight reverse|reverse 作名词有失败、挫折的意思。slightly adv. 稍微
