republic|n.|共和国；共和政体
Marxism|n.|马克思主义
socialism|n.|社会主义
communism|n.|共产主义
regime|n.|统治制度；政权、政体
government|n.|政府、政体、统治
authority|n.|权力；权威人士||the authorities 当局
political|adj.|政治的；政党的
hierarchy|n.|等级制度；统治集团
democracy|n.|民主、民主制度；民主国家
bureaucracy|n.|官僚主义；官僚作风
egalitarian|adj./n.|平等主义的/平等主义者
materialism|n.|唯物主义；唯物论
revolution|n.|革命；巨大变化
reform|v./n.|改革、改良；改过自新/改革、改良
process|n./v.|过程；进程/处理；加工；列队前进
conservative|adj./n.|保守的/保守党员
meltdown|n.|堆芯熔毁；崩溃
municipal|adj.|市政的，地方政府的
neutral|adj.|中立的；中立国的
bilateral|adj.|双边的
arena|n.|竞技场、运动场；舞台、活动领域
flag|n.|旗
banner|n.|横幅、标语
president|n.|总统；校长；董事长
premier|n./adj.|总理、首相/首要的，第一的
minister|n.|部长；大臣；公使
secretary|n.|秘书、书记员、大臣
parliament|n.|议会、国会
senate|n.|大学理事会||the Senate 参议院
conference|n.|（常持续数日的大型正式）会议；正式商谈
meeting|n.|会议；会面
headquarters|n.|总部，总公司；司令部
delegation|n.|代表团；委派
behalf|n.|[on ~ of sb.]代表某人
police|n.|警察||the police 警方
statesman|n.|政治家
mayor|n.|市长
service|n.|服务
office|n.|办公室；要职；官职；[Office]部、局、厅
bureau|n.|局、处、科；办事处
department|n.|（政府的）部门；（大学的）系、所
harness|v.|利用；控制
administration|n.|管理；行政
dominate|v.|支配；控制；占优势
power|n.|能源；权力；政权；能力
influence|n./v.|影响；作用/影响
affect|v.|影响；打动；使悲伤
importance|n.|重要，重要性|The police officer emphasised the importance of careful driving|important adj. 重要的；有势力的。realise the importance 意识到重要性
significance|n.|重要性；意义
organization/organisation|n.|组织；团体；机构
association|n.|协会；团体；关联
union|n.|联合；联盟；工会
community|n.|社区；群体；（生物的）群落
consortium|n.|财团；联营企业
league|n.|联赛；联盟；同盟
institution|n.|机构
unite|v.|联合；团结
unique|adj.|独一无二的；唯一的；独特的
nation|n.|国家；民族；国民
global|adj.|全球的；全世界的
worldwide|adj.|世界范围的；遍及全球的
federal|adj.|联邦的；联合的
foreign|adj.|外国的；外来的；外交的
overseas|adj./adv.|海外的；外国的/向海外；在海外
abroad|adv.|到国外；在国外；广为流传
civil|adj.|公民的；国内的；民用的；斯文的
emigrate|v.|移居国外
immigrate|v.|（从外地）移居；移入
reign|n./v.|君主统治的时期/统治
puppet|n.|玩偶；傀儡
throne|n.|王位；宝座
crown|n./v.|王冠/为...加冕
wreath|n.|花环；花冠；花圈
colony|n.|殖民地
liberty|n.|自由
independence|n.|独立；自立
slum|n.|贫民窟
refuge|n.|避难；庇护；避难所
asylum|n.|庇护；精神病院
population|n.|人口；人口数量
demographic|adj.|人口的，人口统计的
citizen|n.|公民；市民
resident|n./adj.|居民；居住的
ethnic|adj.|民族的；种族的|She is keen on ethnic dance|an ethnic minority 少数民族
racial|adj.|种族的；人种的
clan|n.|宗族；家族；帮派
franchise|v./n.|向…授予（或出售）特许经销权/特许权||the franchise 选举权
entitle|v.|给...权力（或资格）；给...题名||be entitled to/do sth. 有获得某物/做某事的权利
preference|n.|偏爱；优先权
vote|n./v.|选举权；投票/表决、投票|The vote will be held next month|vote against 投票反对
elect|v.|选举；选择
respondent|n.|（民意测验的）调查对象
poll|n.|民意调查；选举投票；投票数
ambition|n.|雄心；抱负
nominate|v.|报名；任命
checklist|n.|清单；选民花名册
succession|n.|连续；继承权；继位
safety|n.|安全；安全场所
welfare|n.|健康；幸福
well-being|n.|康乐；安宁
harmony|n.|协调；和谐；融洽；和声
steady|adj.|稳定的；不摇晃的
flourish|v.|繁荣；兴旺；茁壮成长
succeed|v.|成功
prospect|n.|希望；可能性；风景|There is not much prospect of his being elected as a congressman
perspective|n.|景观；观点|We all have confidence in this new technology from a developmental perspective
viewpoint|n.|观点；看法；视角
standpoint|n.|立场；立足点
outlook|n.|观点；展望；前景
guideline|n.|指导方针
ethic|n.|行为准则；ethics 道德规范，伦理标准|Merchants must observe their code of ethics|ethical adj. 道德的；伦理的。a work ~ 职业道德观
suggest|v.|建议；暗示
advise|v.|劝告；建议；通知
proposal|n.|提议；建议
hint|v./n.|暗示，提示
declare|v.|宣布，宣告，宣称，声称
affirm|v.|断言，坚持声称，证实
claim|n./v.|声称；主张；索赔/声称；要求（拥有）
proclaim|v.|声明；清楚的表明
state|v./n.|陈述；说明/国家，州，状况
announce|v.|宣布，通知
clarify|v.|澄清，阐明
assist|v.|帮助；协助
aid|n.|救助；救援物资；辅助物
encourage|v.|鼓励，激励，怂恿
implement|v./n.|实施；执行/工具；器具
monitor|v./n.|监视；监听/监控器，监视器，班长
admit|v.|供认，承认
African|adj./n.|非洲的/非洲人
European|adj./n.|欧洲的/欧洲人
Latin|adj./n.|拉丁语的，拉丁人的/拉丁人，拉丁语
Jewish|adj.|犹太教的，犹太人的
Arabian|adj.|阿拉伯的
Portuguese|adj./n.|葡萄牙的/葡萄牙人，葡萄牙语
Roman|adj./n.|罗马的/罗马人
Russian|adj./n.|
Spanish|adj./n.|
Swiss|adj./n.|瑞士的/瑞士人
Greek|adj./n.|
Italian|adj./n.|
soviet|adj./n.|苏联的/苏维埃
Indian|adj./n.|
Australia|n.|澳大利亚
New Zealand|n.|
Canada|n.|
Britain|n.|
France|n.|
Germany|n.|
