law|n.|法律；规律；定理|Those who break the law are subjected to justice. 违法者要受到法律的制裁|be subject to something 有；遭受，承受。enact a law 通过法律
legal|adj.|法律的；合法的
rule|n./v.|规则/统治
regulation|n.|规则；规定；管理
item|n.|条目|This is the next item on the agenda|agenda n. 议事日程;（会议的）议程；议事日程;（会议的）议程
treaty|n.|条约；协议
agreement|n.|同意；协定
charter|n./v.|宪章/租；包（船、车、飞机等）
protocol|n.|协定书；协议；礼仪
norm|n.|标准；[~s]行为准则；规范
benchmark|n.|基准，水准点
criteria|n.|[criterion 的复数形式]标准；准则
standard|n.|标准
permit|v.|允许；准许
allow|v.|允许；准许
admission|n.|承认；入场费；准许入场
perform|v.|履行；执行
enforce|v.|强制执行；强行实施；迫使
default|v./n.|不支付、不履行/违约；默认值
reject|v.|拒绝接受；摒弃
constraint|n.|约束；限制，克制
official|adj.|正式的；官方的
mandatory|adj.|法定的；强制的
potent|adj.|很有效的；强有力的
bound|adj.|[be ~ to]一定会；很可能会；有义务
obligation|n.|义务；责任
court|n.|法院；庭院
supreme|adj.|最高的；最大的
enact|v.|通过（法律）；表演
legislate|v.|立法，制定（或通过）法律
equity|n.|公平
fair|adj.|公平的；公章的
just|adj./adv.|公证的；正义的/刚刚；仅仅
prejudice|n.|偏见；成见
discrimination|n.|歧视
accuse|v.|控告；指责
sue|v.|控告，提起诉讼；提出请求
prosecute|v.|检举；起诉
condemn|v.|谴责；指责
complain|v.|抱怨；投诉
boycott|n./v.|抵制；拒绝购买
session|n.|会议；会期
mediate|v.|斡旋；调解||mediate between 在...之间进行调解
plea|n.|辩解理由；借口；请求
appeal|v./n.|呼吁；申述
contradict|v.|反驳；与...矛盾
persuade|v.|说服；使相信
controversy|n.|争议；辩论
whisper|v.|低声说；私下谈论
mutter|v.|低声低语；小声抱怨
murmur|n./v.|低声说/咕哝；低语
silent|adj.|沉默的；寂静无声的|He couldn't speak English and was completely silent during the visit|silence n./v. 沉默；寂静/使安静
mute|adj./n.|缄默的；哑的；无声的/哑巴
investigate|v.|调查
witness|n./v.|目击者；见证人/见证
justify|v.|为...辩护；证明...正当
reasonable|adj.|合理的；理智的
suitable|adj.|合适的，适宜的
judge|n.|法官；裁判员
jury|n.|陪审团；评判委员会|The jury will retire to consider its verdict today. 陪审团今天将退庭商议其裁决|verdict n. 裁决
trial|n.|试验；审判
suspect|n./v.|嫌疑犯/怀疑
sentence|n./v.|判决/宣判
arrest|v./n.|逮捕；吸引（注意）/逮捕||arrest sb.'s attention 引起某人的注意
jail|n./v.|监狱/监禁
prison|n.|监狱，监禁
confine|n./v.|[~s]边界；范围/限制；监禁|this is outside the confines of human knowledge|be confined to 局限于。 within the confines of 在（某范围）之内
oversee|v.|监督；监管
supervise|v.|监督；管理；指导
restrict|v.|限制；限定；约束
restrain|v.|抑制；制止||restrain oneself 克制自己
commit|v.|犯（罪）；做（坏事）
sin|n./s.|罪孽/犯戒律
crime|n.|罪行；犯罪活动
vice|n.|恶行；缺点|Virtue and vise are different things: former leads to peace, the latter to misery|virtue n. 美德；高尚品德。misery n. 痛苦，悲惨；常常不高兴/老发牢骚的人
bribe|n./v.|贿赂/向...行贿||bribery n. 贿赂行为。bribee n. 受贿者 briber n. 行贿者
rob|v.|抢劫；夺走
pirate|n./v.|海盗；盗版者/盗印，窃用
steal|n.|偷，窃取；剽窃
thief|n.|窃贼；偷窃犯
murder|n./v.|谋杀
suicide|n.|自杀
deceive|v.|欺骗；蒙蔽；误导
cheat|v./n.|欺骗；作弊/作弊者
fraud|n.|骗子；赝品；欺诈
liar|n.|说谎的人
trap|n./v.|陷阱；诡计/诱骗
trick|n./v.|诡计/哄骗
pretend|v.|假装，假扮
fool|n./v.|蠢人；傻子/欺骗|A fool's haste is no speed. 欲速则不达|foolish adj. 愚蠢的。make a fool of sb. 愚弄某人。haste n. 仓促，匆忙
stigma|n.|耻辱；污名
confess|v.|供认；忏悔
conform|v.|遵守；顺从；相符合
reconcile|v.|使和解；调和
obey|v.|服从；顺从
succumb|v.|屈服；屈从
penalty|n.|惩罚；处罚
fine|n./adj.|罚款/美好的
mortgage|v./n.|抵押（房屋、土地）借款/房贷
ownership|n.|所有权；物主身份
copyright|n.|版权
privilege|n.|特权
accredit|v.|把...归于；委任
clue|n.|线索；提示
access|n.|通路；查阅（或使用、接近）的机会（或权利）
anonymous|adj.|匿名的
false|adj.|不正确的；虚假的；伪造的
genuine|adj.|真诚的；真正的
procedure|n.|手续；程序
routine|n./adj.|例行公事；常规/惯例的
consequence|n.|后果
demand|v./n.|要求；需要/需求；需求量
request|n./v.|要求；请求
require|v.|需要；命令；规定
petition|v./n.|请求/请愿书；上诉
command|v./n.|命令；指挥；统率/命令；指挥；控制；运用能力||have a good command of 能自如地运用
instruct|v.|指导；讲授；通知；命令
